10.ox
.oo...o...
...ooooo..
....ooo.o.
ooooo..o.o
ooo...oo..
ooo.oo..oo
..oo..o..o
.oo.o...oo
..oo..oo..
.oo......o
